1111111111
10P0000001
1000000001
100C000001
1000000C01
1000000001
100000C001
10000000E1
1111111111
