1111111111
10P000000
1000000001
1000000001
1000000001
1000000001
100000C001
1000000001
10000000E1
1111111111
